1111111111111111
1E00000000C00001
1010010000010101
1010010101000101
1010010101000101
1P00000C000000C1
1111111111111111
